# A province can only belong to one area!

#Sea Areas:
#No restriction on size.

########################################
#Discworld#
########################################

ocean_area = {
	221 222 223 224 225 226 227 228 229 230 231 232 233 234 235 236 237
	238 239 240 241 242 243 244 245 246 247 248 249 250 251 252 253 254
	255 256 257 258 259 260 261 262 263 264 265 266 267 268 269 270 271
	272 273 274 278 279 280 281 282 283 284 285 286 287 288 289 290 291
	292 293 294 295 296 297 298 299 300 301 302 303 304 305 306 307 308
	309 310 311 312 313 314 315 316 317 318 319 320 321 341 342 343 344
	345 346 347 348 349 350 351 352 353 354 355 356
}

#Land Areas:
# A land area is 3 - 10 provinces

########################################
#Discworld#
########################################

sto_plains_area = {
	1 2 19 20 21 22 23 24 322 323 324 325 329
}

the_ramtops_area = {
	25 26 27 28 29 70 71 73 74 75 76 77 78 79 106 107 108
}

klatchian_circle_sea_area = {
	3 4 5 6 7 8 9 14 15 16 17 18
}

klatchian_coast_area = {
	9 10 37 38 39 40 41 42 43 44 45 47 192 326
}

deepest_klatch_area = {
	42 44 45 47 49 50 51 52
}

inner_klatch_area = {
	11 12 13 34 35 36 31 32 33 30 46 48 55 61 62
}

tezuman_region_area = {
	53 54 56 57 58 59 60 64
}

khanli_region_area = {
	64 65 66 67 68 63 132 133 134
}

rehigreed_area = {
	134 135 180 181 182 183 184 185 186 187 188
}

central_plains_area = {
	69 72 129 130 131 339 340
}

brindisi_area = {
	136 137 138 139 140 141 142 172 174 175 176 177 178 179
}

uberwald_area = {
	109 110 122 123 124 125 126 127 128 143 144 145 147 330 331
}

genua_area = {
	146 148 149 157 164 165 166 167 168 169 170 171 173
}

kythia_area = {
	153 154 155 156 158 159 160 161 162 163 189 333
}

rimwards_coast_area = {
	114 115 116 117 118 119 120 121 150 151 152
}

octarine_area = {
	80 81 82 83 84 85 86 87 88
}

hubland_steppes_area = {
	89 93 94 95 96 97 98 102 103 104 105 111 112 113
}

widdershins_coast_area = {
	90 91 92 93 89 99 101 100
}

rim_ocean_area = {
	190 191 193 194 195 196 332 335 336 337
}

agatean_peninsula_area = {
	197 198 199 200
}

agatean_area = {
	201 202 203 204 205 206 207 208 209 210 211 212 213 214 215 327 328
}

volcanic_area = {
	212 211 213 214 215 327 328
}

fourecks_area = {
	214 215 216 217 218 219 220 334 338
}

circle_sea_coast_area = {
	1 2 3 4 5 6 7 8 9 323
}

swamp_sea_coast_area = {
	161 162 163 164 165 166 169 170 173 174 175 176 177 178
}
