#Example: Large parts of Africa and south east Asia
tropical = {
	41 42 44 45 47 49 50 51 52 53 54 56 57 58 59 60 61 63 64 65 66 67
	133 134 166 169 170 173 174 175 191 194 332 335
}

arid = {
	11 12 13 34 35 36 33 32 31 46 48 55 62 10 37 43 14 68 131 132 135 136
	206 207 208 209 210 211 212 213 214 215 216 217 218 219 220 327 328
}

arctic = {
}

#Example: Most of Europe north of med.
mild_winter = {
	1 2 18 19 20 21 22 23 24 25 26 27 29 71 72 77 78 79 80 81 129 130 138
	139 141 142 143 146 148 171 160 161 163 164 167 168 322 323 324 325
	329 200 339 340
}

#Example: Inland Europe & Scandinavia
normal_winter = {
	82 83 84 85 86 87 88 89 94 95 96 28 73 74 75 76 103 104 105 106 107
	108 122 123 125 126 127 128 144 145 147 149 150 156 157 158 159 330
	331 199
}

#Example: Russia & Lappland
severe_winter = {
	90 91 92 93 97 98 99 100 102 112 113 114 116 117 118 119 120 151 152
	153 154 155 109 124 101 115 197 198 111 110 121
}

impassable = {
	278 279 280 281 282 283 284 285 286 287 288 289 290 291 292 293 294
	295 296 297 298 299 300 301 302 303 304 305 306 307 308 309 310 311
	312 313 314 315 316 317 318 319 320 321
}